NO ./path_to_the_north_texture.xpm
SO ./path_to_the_south_texture.xpm
WE ./path_to_the_west_texture.xpm
EA ./path_to_the_east_texture.xpm

F 226,100,0
C 225,30,0



              11111111111       
          1111000000000001111     
        11000000000000000000011
      110000000000000000000000011
     10000000000000000000000000001
    1000000001110000000111000000001
    100000001   1000001   100000001
   100000000011100000001110000000001
   100000000000000N00000000000000001                                    
   100000000000000000000000000000001
    1000001111111111111111110000001
    1000001                10000001
     100000111          1110000001
      11000000111     11100000011
        11000000011111000000011
          1111000000000001111
              11111111111         