NO ./maps/texture/north.xpm
SO ./maps/texture/south.xpm
WE ./maps/texture/west.xpm
EA ./maps/texture/east.xpm

F 220,100,0
C 225,30,0
F 100,100,100

111111
100001
100N01
100001
100001
111111 