NO ./path_to_the_north_texture.xpm
EA ./path_to_the_east_texture.xpm
C 225,30,0
SO ./path_to_the_south_texture.xpm
WE ./path_to_the_west_texture.xpm

F 226,100,0
C 225,30,0

                                                                                
111111
100001
1000011111
10N0011111
1000011111
111111 